------------------------X------------------------------------B---------------------------------------------------------------------------------------------------------------------------------X--------
--------B---------------------------------------X-----------------------------B---X------X-------------------------------X------------------------------------------------X--------------------------X--
---X----------------B-------------B----------------------------------------------------------X----X-------------X-X-------------------------------------------------------------------------------------
----------------------X---------------------------------------------------------------B-----B-------------X-----------X------B-------------------------X--------------X-X--------------X----------------
-----------X---------------------------X--B--X----X----------B----------X---X----X---------------------B-------------------X------------------------------------X------X----------------X---------X-----
------------X---------B-------------------------------------------------------X---B-------------------X-------------------------------------------------------------------------------------------------
----------------------------------X--B--------------------B----------------------------------------B--------------------X-------B---------B-X---------------------X-----------------B-------------------
----------------------X-----------------------------X---------------------------------------------------------------------------------------------------------------------------------------X---------v-
---B-X-----------------------X-------------------------------X-------B-X----------X---------------X-X----------------X----------------B--------------------------X---X--------------------------X---X-f-
-----------------------------------------------?----------------X---------B------------------X---------------------------------------X--------------------X--------X----B------B----------------------f-
-B-----------------B--------------------------X---------------------------------------B-------------B-----------------------------------------------X-------------X-----------------------------------X-
---------?---------------------------------------------XX--------------------B-----------------------------------------------------------X---X-------------X-----------------X--X-X-------------------f-
-------BX---------------X----------------X-----B----------------B---------X---------------------------------B-----------------------X----------------------------------------------------------X------f-
--------------------------------X-------------------------B---X--------B---------------------------------------X--------------------------------------------------------------------------------------f-
-m-----------------------------o-------M-X------------------------------|-------------B-------------------------------X---------------o----------M------B--------------------------------------------XX-
XXXXXXXXXX-XXXXXXXXXXXXXXXXXXXXXXXXXXXX-XX-XXXXXXX-XXXXXXXXXXXXXXXXXXXXXX--XXXXXXXXXXX-XXXXXXX--XXXXXXXXXXXXXXXXXXXXXXXXXXXXXXXXXXXXXXXXXX-X-XXX-XXXXXX-XXXXXXXXXXXXXXX-XXXXXXXXXXXXXXXXXXXXXXXXXXXXXXXX
