----------B----------B-------X-------X-------------X-X-------X-X-------X-------B----------------------------------------X--o------------------X------X--------------------------------------------------
-----------B-----------------X------X-------B-------------------X----------X-----------------------------B-X-----------Xo--B------------------X------B-B---X----------------X-B--B----------------------
-------X---------XX----------------------X------------------B-------X--X---------------------------------X-----------X----------------X-------?------X-----------------------------X------------------X-
------B-------------BM------------X------B----------------------------------B------------------------BX---------B---X--------------------------X-----------X------------X----------------------X--------
-B-------------X---------------------------------------X-X-----X------------------B--------------X--------------------------------------------------------------------------------B---------------------
----X--------------------------------------X------B--M----------X-------------------B----X------------B---------o------------------X------------------------------B--------------------------B----B-----
-B------------------X-----------------X-X-------X---X--------B-B---B---------------------B--------X--------------X----------------------------------------------------------X----------X--------------B-
------------X--------------X------------------B-----------------------------X----------------------------X-------X----------------------X----------X------X-X--------B---X-----------X----------------v-
-------X------o-------X------X--------X-----------B-----------------B--X---------X-------X------------X--------------------------------------------------B----------------------X--X--B-----X---------B-
-----X---------X----------------------------X----------------------------X------------------------X------------------------X------X------X-----------------------X--X---------B--------------------BX-f-
--------------B-------X-BX-----X-------X-B----------B--------------B--------M-----------------------------------------X-BX-B-X-------------------B--X---------------------------X-------B---------X---f-
-----------------------------XX-------X-----------------X-------------------B----------------------X----------XB------------------X------------------------------------X--B-------B--------B----------f-
-X---?----------X-----------------------------X---------------------M-------X----------------B----XB-B--------------X----B-------------B-----------B-----B----XX-B--------------------X-----X-----X---f-
-o--X---------------------------------X------X---B---X--------------X----------------------------------X--------------B-X------XX---------XB--------X-----------X-----X------XB-B---------------------f-
-mX--X----------------X---------------------X-X--------------o----------o--------------B-----?------------X----------------X--X--------------------B--M-X-X-------o-----X--------o--B-X?--------------X-
XXXXXXXXXXXXXX-XXXXXX-XXXXX-XXXXXXXXXXX-XXX-XXXXXXXXXXXXXXXXXXXXXXXX-XXXXXXXX-XXXXXXXXXXXXXXXXXXXXXXX-XXXX-X-XXXXX-XX-XXXX-XX-XXXXXXXX-XXXXXXXXXXXXXXXXXXXXXXXXXXXXXXXX-XXXXXXXXX-XXXXXXXXXXXXXXXXXXXXXX
