-------X----------X-------------------B---------------------X-X------B------------------------------------X-----X-----------B-------------B--------------------o----------------------------------------
------X--------B-----X-------------------------------------------X----------------------X-X--------X----X----------X--------oX---X-B-----------X----XX----------B--------X----BB-----------XB-----------
--------------------------------------------------------------------B----------X-X-X-------X------X------------X------------X---------------X-----X---------X-----------X-------------------------------
-----------------------------------------------------X--X----B-------------X-------X-X----------------------------------------------------------X-----------------------------X----------------X--------
--X--------X--B-----------------X-----------------X-----------B--X-------------X-----X---------X---------------------B--B---------------------------------------------B-X-------------B-X------X--------
-X------------------XX-B------------B-B--X-----------------B--------X-X-------------------------X-----------------------------------------------------------o----------------------B--------------------
-----------------X-------X-----B------------B--------------------------------------------------------------------------------B------------------X----X------X---------------X-----XX--------------------
---------------X----X-------------------------------------------X---------------------X---------X------------------------------------X------M-----XB------X-----------B-------------B---------X-X------v
-----------X-X---X------B------B--------B--------------------X-----------------------B------------------X-----------XX--------B------------X---------------------X-------------B-----------B-----------f
---------------X----XX------------------------------------------X----X------------------------X------------------o-------X-XB----------X-------------------------X---------------X-X-------------B-----f
-B---------------------X--------B-----------------------------------------------------------------------------X----------------------------------B--X-o----------------------------B--------------X----f
----------------------------------------------X--------X------------------------X------M----BX----------X---------------------------B---X----X----?-----B--------------B-------X------------X--X-------f
----B----B--X-------------------------------------------------------------------------X-X--------B----------X----X------------------------B--------X------X-------X------------------------------B-----f
---------B--------------------X------------B--------------X--------------------------------------------------------------------B-----------------X------------B--X----B----------------XB-----X--------f
m----------?|---?---------------------o---------------------X------------------------------M--------X--------------------B------------------------------------------------------------------------o----X
XXXXXXXXXXX-XXXXXXXXXXXXXXXXXXXXXXXXXXXXXXXXXXX-XXXXXXXXXXXXXXXXXXXXXXXXX-XXX-XXXXXXXXXX-XXXXXXX-XXXXXXXXXXXXXX-XXXXXXXXXXXXXXXXXXXXXXXXXXXXXXXXXXXXXXXXXXX-XXXXXXXXXXXXXXX-XXXXXXXXXXXXXXXXXXXXX-XXXXXX
