-X-------XX-------X------X---------------------------B------------------------------------X-------------------X-------------------------------------------XX--------------------------------------------
----------------------------------X---X-------------XX-X--X--B-X-----------X------B-----------------------X-----------------X----------------X-----X-B--------------------------------------------------
---------B----------------------------------------------------------X-------------------------X--------------------------X--------------X----X---------------------X------X-----------------------------
---------------------------------------------------------------------------------------X---------X-------------------------------------------X--------------------------------X-------------------------
---------------------X------------------------------------------------------B----XB--------------------------------------------------------------------------------------B---B--------------------------
------X-------------------------------B-------X----X--------X-----------------------X----BX------B---------------------B---X----------------X---------B--------?-------------------------B--------------
---o----------B---------------------------------------------------------------------------------X--------------------B----------------------------------------X-----------------------------------------
--X-------------------------------------------------X----------------------------------X-----X---------------------------X------X-----X--------------------------------------X-----------------B------X-
----------------------------X------------X------------X------B----------X--------X-----------------X-------------------------------------B---------------X------------------------------B--X---------Bf-
-------X----------------------B-X-----------X----------------X---------------------B----------------------X---------------------------B----------------------------------B--------X-------------------f-
----------------------------------------------------------B---------B-------------------------------------B-B------------------------------------------------------X---o------------------------X----Bf-
---------B--------X-----------------B-------------------------------------------------------------------B---B---B----X--------------------------------------------------BB----------------------------f-
------------------------X-B--------X--------------------------------------------X--------------X--B-----------------X-------------------------------------B----X--------------------B-----------------f-
---X---------------------------X----------------------------------------------------------------------------------------X---X----------------------X--------------------------B---X-------------------f-
-m------?---?-------?---X------X---B----------------------------------X------B---------X---------------------------------------------------------?-----------------------------------------X----------X-
XXXXXXXXXXXXXXXXXX-XXXXXXXXXXXXXXXXXXXXXX-X-XXXXXXXXXXXXXXXXXXX-XXXXXXXX-XXXXXXXXXXXXXXXXXXXXXXXXXXXXXXXXXXX-XXXXXXXXX-XXXXXXXXXXXXXXXXXXX-XXXXXX-XXXXXXXXXXXXXXXXX-XXXXXXXXXXXXXXXXXXXXXXXXXXXXXXXXXXXX
