------------------------------X--X---X------M-----------------B-X-----------------------------------------------------X--------B----------------B----XB--------------X----------------------------B-----
--------------------B--B-----X-------------X---------X------------------------------------B----------B---X---------------------------------------------------B-----X---Xo----------------------------X--
--X------------B----------------------------------------B----------------------------X------------B----B-----------------------------------B--------------------------B-X----------------B----B-B-------
-------------------------------o-------------B-------------X--------X-------------------------------X----X--------------------------------------------------------------------X----------------X--------
-------------------------------B-------------------------X----XX----------------------B----------------------------X-------X--------------------X-------------X--------------------------------X--------
---------------B-----------X------------------X------B------------------B------------X-----------X-----X-------------------------X--B--------------------------------------------------------?----------
---B-----------------------------X-----BB-----------X---------------------X-----X----------------------------------------------------X---X-------------B-------------------------------------X--X-------
-------------------------------------------------X---------B---X-----------X---------B----------X-----BX------------------------------------------------------------------------X---------------------v-
--B--------B-------------------------X---X--------------------X-X--------------------------------------B------------X---------------------------X-----------B-----------------X--------X--------X-----f-
-B-------------------X-X-----X----------------------------------------------------------B-----X-------------------------------------------------------X--------------X-----XX-----X---B---------------f-
-B-------------------------------------------X-----------------B-----------X-------X---------------------------X------------------------X------------------------------------------------B------------f-
-------------------------X---B-------------------------B------X------X-------------B---o-------------------------------B----------------B--------------------------X----X-------------X-------X---------
------------X----------------------X----------------B----B-X-----X-------X--------------B------------X-----X---------o--B--XX--B---------X----------------------X-------------------------------------f-
---X----X--------------------------B------------------------------------X------------B---------------------------X---X--------------------X--B---------X--------------B-----XB------------------------f-
-m--XX-----------|-|-----o-------------------------B-----------X----X----X--?----------|-----M---B---------------------------?---o--|B--B----------------o----B-------------o-------------------------X-
XXXXX-XXXXXXXXXX-XXXXXXXXXXXXXXXXXXXXXXXXXXXXXXXXXXXXXXXXXXXXXXXX-XXXXX-XXXXX-XXXXXXXXXXXXXXXXXXXX-XXXXXXXXXXXXXXXXXXXXXXXXXXXXXXXXXXXXXXXXXXXXXXXX-XXX-X-XXXXXXXXXXXXXXXXXXXXXXX-XXXXXXXXXXXXXXXXXXXXXX
