------X------------------------B--X---------------------------------B-----------------------B-----------------X----------------B----X----------------------------B-X---------------------------X---X----
-------------X-------------------------------X------------------------------------------------------------B-X------X--------------------X----------------------------------X---B--X---------------------
-------------------------------X------------------------------------------------------------------------------------------------X-----------------------------------------------------------------------
---o---------------X----------------------B----------------X-----X-----XB-------------X------B---XX----------------------------------------------X------------------------------X------------X---X----X-
----BX--------------------------XB---B---------------------B-------------B---------------------------------------B----B-------------------X------------X---------------------------B---------B---X---X--
-------------------------X-------------------X-X-B--------------------------------------------------------X----------------B------------X------B----BX----------------XX---------B-----B--------X-------
---------------B-------X-----------------------------------------------------X----------------------XX----------------------------------------------X-X-----------X-------B--------------X--------------
----------X-o------------X------------------------XX-----------------------B---------------------------------------XX------B------------------------------------B-------X------------X-----------------v
-----------XB--------------------B-X-B-----X---------------------------------X-------------------------------------------B----------------------------------------------------------------------X------f
----X-------------------------B---------X--------------------X-----------------------------B--------------B------B---------------X--------B-------X-B-----------XX-----------B------X------------------f
--------------------------B---X-----------X-----------------------------B--XX---------X-----------X--------------------------X--------------------X----------X-----------------------X--X--------------f
----X----------------------------X-------X--------X-----B-----------------------X------------X--------------X--------------------------------------------------------------------------------B-X------Bf
-B-------------------------------------X-------BB-----B-B------------------------X--------------------------------------B---B-------X---------------------------X---X-B-XB-------------------X---------f
--------------------------------------------------------------------------------------------------------------------------X--------------B---X------------X------------------------------X----B--------f
m------X-------------------------B----------------------------------?--------?----o----------X-------X--------------------------------------------------B---X------------------------------------------X
XXXXXXXXXXXXXXXXXXXXXX-XXXXXXXXXXXXXXXXXX-XXXX-XXXXXXX-XXXXXXXXXXXX---XXXXXXX--XXX-XXX-XXX-XXXXX-XXXXXXXXXXXXXXXXXXXXXXXXXXXXXXXXXXXXXXX--XXXXXXXX----XXXXXX-XXXXXXXXXXXXXXXXXXXXXXXXXXXXXXXXXXXXXXX-XXX
