-------------------------------B----------------------X-------------------------------------B---------X--------B----------------------------------------------------------------------------------------
------------------------------X----------------------------------------------------------------------X-------------------------------------------X---------------B------X------------------X------------
-----------------------B-----X--------------X-------------------------------------------------------X-----------B----------------------------B--------------B------------------------------------X------
-------X------------------------------------------X----------------------------------------------X--------------------------------------X----------X--------X-------------------------------------------
--X-------------------XX---------XB----------X----------------------B--------------------------------------------------X-----------------------X-------------------------------------------------X---B--
------------------------------------------------------X-------------------------------X---------------------------X-------------------------------------------X-----------------------------------------
-------B----X--------------------------------X----------------X-X-------------------------------------------------------------------------------------X-------------------X------?----------------------
-----X------------------B----------B----B----------B--------------X---------------------------------------------------------X--X-------------------X-----X----XB-X---------------XX--------------------v
---------------------------------------------------------o--------------BX----------------------------------------------B-----------------------X------------------------------------------------------f
--------------------------------------------------------B---------------------------X-------------B---------X----------XB-------------------?---------------------X-------------------------X----------f
-----------?---------------------X-----------B---------------------X-------------------------------------------------B---------------------X--XB-----------B-------------------------X--------BX---X---f
-----------B------------X------------------------------------B------X------------X----------X------X---X-------X-------------------------------------------------------------X-X---XX-----------X------f
------------------------B------------B-----X--------------------------------------X-----------------------------------------X----B-------X----B-------------------------X-B--------XX-----------X------f
----------------------------------X-X-----------------------------------X------X---XBB---------------------------------------X-------X-------B-----------------------X-----X----------------------BXX--f
m--X--X------X---------------------X------------------------|----o----------------------------X-------------------------------|----------------------|----------------?---------------o------X---------X
XXXXXXXXXXXXXXXX-XX-XXXXX-XX-XXXXXX-XXXX-XXXXXXXX-XXXXXXXXXXXXXXXXXXXXXXXXXXXX-XX-XXXXXXXXXXXXX-XXXXXXXXXX-XXXXXXXXXXXXXXXXXXXXXXXXXXXXXXXXXXXXXXXXXXXXXXXXXXX-XXXXXXXXXXXXXXX-XXXXXXXXXXXX-XXXXXXXXXXXX
