---X-------B--X----------X--------------------------------B---------------------------X------B----------------------------BX-----------------------X-----X----X-------B--------X----B-------------------
---------X----------X---------------------------o-------------X-------------B---------------B----------X----------------------------X----------------------X-----------------B--------------------------
----B--------------o----------------X-----------X-----------M--------------------------X-X--------X------------------------------X------------------------------------------------------M-----------B---
----------------X-B---------B----B------------X----B---------X--B--B------------------------------------------B-------------B--X----X-------X-------------M---------------B-X------------X-----B--------
----------------------------------------X------------------X------------------B-----------------B------B--------------------------------------X-----------X-----B--B--B--------B------------X-----------
------------------------------------B----B----B--------X---B---X----------------------B---X--X--------------X-------B-----------------------X--------------------------X---X-B----X----------X---B------
--------------B------------B--X-X--------------------------------B---------B-X-X-----------X---------------X----------XX----------------------------X----------X-BX----------------------------X------X-
--------------------------------------------------------------------------------------B--------X-----X--------------------X-------------------X-----------X-------B-----------------------------------v-
----X--X--------X---X-----X--------X------------------------B----------------------------X----------------------------------X-------------------------------B---B-------------------------X-------X--Xf-
--------------B-----X---------X?X--------------------------X------------------------------B-----X------------------------------------B---------------------X------------------------X-------------------
-------X---------------------X-XX----------X-X---------X--X---X-----------------B-------------------------X----B----------X--------------------X----------X-----------------------------------------X-f-
--------B--------B--B-----------------------------B-------------------X-----------------B--------------------X--BX---------------------B---------------X----X-----------------------------------------f-
------X----------------X-------------X---------X-------X------X-----------------------------------------------X---------------------X--------------X------X------B-o-----------------------------M--X-f-
----------X------------------------------B------X---B-------------------------X--------------------B----------X------------X-X----------X-------B-----B-----X------X-----X-----X----------------B-----f-
-m------B------X----------------------------------B----Xo-----Xo---o--------o---X------------------------------o--------------o-X-------------X----?X---------------------------------------------------
XXXXXXXXXXXXXX-XXXXXXX-XXXXXXXX-XXXXXXX-XXXXXXX-XXXXXXXX-XXX-XXXXX-X--X-XXX-XXXXXXXXXXXXX-XXXXXXXXX-X-XXXXXXXXXXX-XXXXXXXXXXXXXXX-XXXXXXX-XXXXXXXXXXXXXXXXXXXXXX-XXXX-XXX-XXXXXXXXXXXXXXXXXXXXXXXXXXXXXX
