---------X-----------------------------------------------------------------------------------------------X----------------B---------X----B--------------------------------B----X------------------------
---------------------------------------------------------------X---X-----------------------------X---------------X-----X-------------------------B-------------------------B----------------------B-----
-X---------------------X----M-B--X----------------------------------------------------------------X--------------------------X----------------------------------------------X--------------X------------
------B---------------------X---------------------------------------------------X-------------X--X--------------------X--------------------B------------------------------------------------------------
---B---------------------X------B----------X-----------------------------------------------------------------------------------------------X------------------------------------------------------------
---------------------------------------------B----------------X--------BX---------X------B--X-----------------------------------X---B------B--------------------------------X---------XX------X---------
-------------------------------------------------------------B---X-----------------B-------------------------X-------------X----------------------X----------------B------------------------------------
-------------------------------B------------------------B--------------------------------------------X-----------------------------B------X----------B------------X------------------------------------v
----------------X--------------------------B-------B-X----B----------------------XX----------------------B------------------------X-----------------------XX-----B--------------------X--------X-------f
-----------------------X-----------------------B-----B?-----------X-----------------------------------------------------------------------------------X---------X-----------X--------------------------f
--------------B--X---------------------------------B-X----X-------------------------------------------------------------B----X-B-----------------------X-----------------------------X-----------------f
-------------------------------B----------XB--------------------------------------B-----------------X----------------------------X-------------------B---X-----------------------X-----------?---------f
--------XB---------------B--------------B--------X----------------------------------------------X--------------------------------------------B---X---X-------------------------X-------B------BXB------f
---------------X---------------------------------------------------------------------------------------------B----------X-----------------------------X------B----------------------------------B------f
mX-----------------|---X--------?---------------------------------------------oX-----------B---------?-------------X-X--------X---------------------------|--------------Bo---------M-------X--------X-X
XXXXXXXXX-XXXX-XXXXXXXXXXXXXXXXXXXXXXXXXXXXXXXXXXXXXXXXXXXXXXXXXXXXXXXX-XXXXXX-XXXXXXXXXXXXXXXXXXXX-XXXXXXXX-XXX--XXXXXXXXXXXXXXXXXXXXXXXXXXXXXXXXX-XXXXXXXXXXXXXXXXXXXXXXXXXXXXXXXXXXX-XXXXXXXXXXX-XXXX
