---------X-----------------------X--------------------X--X-----------X-X-X-----------------------------B-----B-B-----------------X---B--------------X-----------X-------X-----X-------------o-----------
------------------------------------------------------------------B--------------X--X-----------------X-----------------------B------------------------------------X---------------------B--X-----------
-----X-----------------X------------B----------------------XB------------------------X----------------------------------------------X----------------X----------------XB---X-------------------B--------
---------------------------X----------X-------------X---------X------------------------------X---------------------------------------------------B--------------------------B-------------------------X-
------------------------------B-------------------------------------------------X-B--------------------XB--X-----X---B-------X-----X-X---X-------------------------------------B------B-----------------
-------X-------------------------------------X---------B-------------------X-------------X---------------X----------------------------------------------------------X----------------X------------------
-----------------------------------------------------------------------BX----------X-------------------X------------------------X-------------------------o---------------------------------------------
-----B------X-------B--------------------X------------------------------------------------X---------------------------------X----X------------------------X-------X---------------X--------------------v
----------X----------X----------X-----------X-X--------B--------------------------------------------------------------------------------------------------------------------------------------------B--f
----------------------------------------------------------B----------------------X-------------X----------X--------------------------------------------------------------------------------------------f
----X------------------B----B------X--------------------X------------X---X-----------------------------------------------------------------------X-------------------------X-----------X---------------f
-----------------------X--------------------------X----------------------------B------X------------------------------------------B-------------------X-------------------------------------------------f
----------------------------B-----------XBX-----B----------------------X------B-----------------------------------X----X-------------B--------------B-------------X-----X--------B---------------X-----f
------------------------------X---------------------------------------------------------X-------------------------------------------B-------------------------------------------------X----------------f
m?-----?--------o-----X-?-----------------------|-------?---?------B------------------------------?----------------?-----------------o---------------------------------------------------------B-------X
XX-XXXXX-XXXXXXXXXXXX-X--XXXXXXXXXXXXXXXX-XXXXXXXXXXXXXXXXXXXXXXXXXXX-XXXXXXXXXXXXXX-X-XX-XXXXXXXXXX-XXXXXXXXXXXXXX-XX-XXXXXXXXXXXXXX-XXX-XX-XX-XXXXXXXXXXXXXXXXXXXXXXXXXXXXX-XXXXXXXXXX-XXX-XXXX-XXX-XX
