------------B---------------------------X--------------B----------------------X--X------------------------X-------------------------------------------------------XX-------X------------B-----X--X------
--------X---X----------------------------------------------------------------X-X---X------------------X---------------------------------------------------X---------B-------------------------X--X-B----
------X---------------oX--------------------X-------------------------------------------------------------------------------------------X----X-------------------------------------------B--------------
-X--------------------X-----------------------X-------X--------------B-----B-------------X---------------------X--X--------B-----------------------------------X----------X------X---------------X------
------------X--------------------B-----X----------------------------------------------X--------X------------------------X------------X-B----------X-----------------------------------------------------
-----B---------B------------B-------X-------X----B-X---------------------------------------B-------------------B-------------------------X--------------------------XX----------X-----------------------
-------------------------------B--------X----------------------B-----------------B----------X-----------------------------X--------------------------------------------X-------------?-----X---------X--
--X---X--------B-----------B---------------------X?----------------------------X----------B---------B----X---X------X----------------------------X--X-------------------------------B-----------------v-
-------X---X------?--------------------------------B--------------------------------------------------------------------B------------------------------B------------X-------------X-X-----------------f-
--------X---------X----------B-------------------------------------o-X-------------------------X--------BB------------------B-------XX------------------------------------------X-----X---------------f-
----------------------X----------X------B-------------B-X-------X--------------------------------X-------------------X----------------X--------------------------------------X--------------X-----------
---------X--------------------------?-----X---X----------------------------------X-----------------------------------------X-----------------------X-------------------X-------------------------X---Xf-
---B--------------------X-----X-----B-----B--------------------------------------------------------------------------X-X---X-----------B----------------------X---------------------------------------f-
---------------------------X-----B----X-----------X-------------------------X--------------X---------------------X-------X------------------X-------------X-X----X---BB----X----------------------X---f-
-m------X-----?-----X---X---------X--------?-------B-------------------------------------X----|---?---------X------------B--X------B-----B--X-X--------------X--M-B-------------M---------------------X-
XXX-XXXXX-X-XXXX-XXXXXXXXXXXX-XXXXXXXXXXXXXXX-XXXXXXXXXXXXXXXXXXX-XXXXX-XXX-XXX-XXXXXXXXXXXXXX-XXXX--XXXXXXXXXXXXXXXXXXX-X-XXXXXXXXXXXXXXXXX-XX--XXXXXXX-XXXXXX-XX-X-XXXXXXXXX-XX-XX-XXXXX-XXX-XXXXXXXXX
