--------------------------------------------B-B-----X-----B----------------------X------B---------X------------------X-X----------------------------------X-------X-------------------------------------
---X---------X--------X----X-o------X-------------X---------------------------------------------------------X----------------------------X------------X-----B-X----------X---B--------X-----------------
-------------B-------BB-------X----B-------------------X--------------------B----B-------------------------------X----X-B---------------------------X-----------X------------------------------X--------
-----------------X------------------------------X-------------------------------------------------------------------XX--------------------------------X-X--X----------------------------------B---------
------X---------X------------------X-------X----------------------------------------B------------------------------------XB-------------------------------------------X-B-----------------X---X---------
-------------X------------------B---B-----------------------------X-----X-----X-----------------------------------------X----X-----X------X-B-----------------------------B-----------------------------
-----------------B-----BX--X--------------B-------X--------B----X---B---------B---------------------------------------------B--X------------------------X---------------------B-----B-X-----------------
-------X------------------X-----------------------X--------------------------X---------------------------X---X----------X---------X------X-----------B--------X-----------------------------X----------v
-------X----------------------------------------B----X---------XX---------------------------------------------------------------------------------BX-------------XB-------X-X----X-----------X---------f
-------B-B----BB------------------------B--------------------B----------X-----------B----------------X------------X---------X------X--------------------------------------------------------------BB-X-f
----o----------------------------------------------------------X-------------------X----------------------------------------------------------XX----------------------B--X----XX----X----------------X-f
----X---------------------------------------------------X-X--------------B--X--------B----------o------------X-----------------X--------------------------X--------X-----------------------------------f
------------X--X-------------------------------X------------------X------X-B---------------------X------------X-----------------------------?---------------------XX----------------------------X------f
----------------B--------------X------------B---------------------------------X-----X----------XX--------------------B-------------------o-XX---?-------------------X-------o-X------------------X----of
m---------|----------------|----------------o--------------------------------------o--------MX------------Xo------------------------------X-----X----------------------------|--------B------X-------B-X
XXXXXX-XX-XX-XXXXXXXXXXXXXXXXXXXXXXXXXXXXXXX-XXXX--XXXXXXXXXXX-XXXXXXX-XXXXXXXXXXXXXXXXXXXX-XXXXXXXXXXXXXXXXX-X-XXXXXXXXXXXXXXXXXXXXXXXXXXXXXXXXX-XXXXXXXXXXXXXXXXXXXXXXXX-XXXX-XXX-XXXXXX-XXXXXXXX-XXXX
