--------------------------------------------------------------X-----X----------------------------------------?-X----------------------------------------------------------------------------------------
---------X------------------B----------------------------------------------------------X----------------------X---------------------------------X------------X----------------------------X-------------
------------------------------------------X---------------------------------------------------------X---------------X-----------------------------------------------------------------------------------
--------B------X------------------------------------X-------X------------------------X-------------X---------------------------------------------------------------------------------X-----X------------
--------------X-----X-----B--X---X-----------------B----------------------------------------X-B-----------------------------------------------------------------------B-------------X-------------------
---------------------X----------------------------------------------------------------------------------------BX-----------------------B-----------------------------------B----------------------------
-X--------------------------X------B-----------X---------B-----------------------------X-B----------------------------------X--------------------------X------------B--------X--------------------------
-----------------------BX-----------------B-----------------------------X---------------B---------------------X---B----B-------------X------------------------B-------------------------------------X--v
----------------------------X-------------------------------------------X--------X---------------B----------------------------------------X---------------X------------------------------------------B-f
------------------X----------------------------------------X---?--------------------X---------------------------------------------X--------------B--------------B--------------------B----------------Bf
-----------------------------------------------------------------------B-----------X---X------------------------------------------------------------X-------------------------X------------B-----------f
-------------------------BXX---------------X---------------------------------------------------------X-------------B-----------------------------------------------------------------------------------f
-----B--------------X----------------------------B------------------X------------------------------------------------------------------------------X-----B----B-------------------------B--X-X---------f
--------X-------X------X-----------------------------------------------------------M----------X-X----------------------------X----------------------------------X-------X------------------------------f
m------o-----B--------------M----------------B--X-----------------------------------X-B---?----M-----o---o--------------------------?------B-------X----------------X-----B-o-------------------------BX
XX-XXXXXXXXXXX-XXXXXXXXXXXXX-XXXXX-XXXXXXXXXXXXXXXXXXXXXXX-XXXXXXXXXXXXXXXXXXXXXXXXXXX--XXXXXXXXX-X-XXXX-XXXXXXXXXX--XXXXXXXXXXXX-XXXXXXXXXX--XXXXX-XXXX-XXXXXXXXXXXXXXXXXXXXXXXXXXX-XXXXXXXXXXXXXX-XXXX
