------------------X---------------------------------X-----------X--X----X---------------------------------------------X--X----------XX------------------------B-------------------B---------------------
-----------------------------------------------X--B---------------------------X---X------------------X----------------------X--------X--X------X------------------------------X-------------------------
-X---------B-X--------------------------------------B-----X---------------------------X---X---B------------------------------------------X----X-X-----X------------------X-----------------X----------B-
--------X---------X-----B---------X----------------------------------------------B---------------------------------B-B--------------------X-------------------------------------------X----------X------
----X------------B---B------------X------X-------B----------X----X----------B-----------------X---------------------B--------X--------------------------------------X-------------------------------X---
-------------------------------------------B-X------B--X---X---X---------------------X-----------------------------------------X--------------------B------------------------------X--X-------X---------
-------------X---------------------X--------------X---------X--------------B--X--------X----------------B---X------------X--------------XB------X------------------------X--------------------X---------
---------B--------------------------------------------------------------------X----X--------------------------X--X--------------------------------------------B---------------------------------X-----v-
--------X-----------------------X--------------X----B-----------------------------------------------------------------X---------------------------------------------------X----------X----------------f-
------X---------------------------X----------X----------------------B------------B-X------------------------------------------B--------------X-----XB------------B-------------------B--------X---X-X-f-
----------o-B--------------------B--X--------X------XX-----------------------------------?-------------------X----------------------------B---------------------------------------X-------------------f-
--X------BX------------------X-------X-----X-?------------------------X--X----------------XX-----------------------------------X---X--------------------------------------------------X---------------f-
--------B-------------------------------X----B---------X-----------------------------B------X---X---------------------------------------------------------------------------B---------------------------
----X-XX-------XX----X--------------------------------------X---------X----------------B-----------X---------X----X--------------B----------------------------------------------------X---------------f-
-m-----o-----------------------------X----X------X----------------B-----B-----------------X-X---X-----X--------------------------------------------------------------------------?---------B----------X-
XXX-XXXXXXXXXXXX-XXXXXXXXXXXXXXXXXXX-X-XXXXXXXXXXXXXXXXXXXXXXXX-XX-XXX-XXXXX-XXXXXX--XXXXXXXXXXXXX-XXXX--X-X-XXXXXXXXXXXXXX-XXXXXXXXX-XXXX-XXXX-XXXXXXX-XXXXXXXXXXXX-XXX-XXXXXX--XXXXXXXXXXXXXXXXXXXXXXX
