----------------B--------B----------------------------------------------------------------B-----------------------B----B---------------------B----------X----------------X------------------------------
-------------------------------------------------------------X-----------------------------------------------------------------------------------------X--------------X-------------------X-------------
---------X-------B---------------------------------------------------X------------B--------------------------------------------------------------------------X------------------------------------------
-------------------------------------------X---------------------------B---------------X--B---X------------------B--B--X-----------------------------------o--------------------------------------------
------------------B-----------------------XX-----------------------------B---------------------------B---------X----------------------------X--------------X---------------------------------B----------
---------X--------------------------X--------------------------------------------------X-X-------B-----------------------------X-----X--------X----X-----------------------X----------------------------
------XX---B---------------X-------------------------------------------------B-----------------------X--------------------------------------------B-----------------B---B-------------------------------
----------------------B-------X--------------------B-------------------------------------------------------B-------X-----------X------------------------------X---------------------------------------v-
-------------------------X---------------------------------B------B----X-------------X---------B---X---------X----X---B--------------------------------------------------B----------------------------f-
-----------------B------------------------------------------------------------X-----------B---X---------------------------------------------------------------------------------B-------------X-------f-
------X---------X----------------------------------------------------------------XX-------------B--------------------------------X--------------------------------------------------------X-----------f-
-------------------X------------------------------------------X--------------------------X---------B----------------------------------------------------X-------XX-X---------------------B------------f-
--------------X----------X------------------X-----B------------------X-------X--------X-X--X------B-----------------------------B-------------------------------------------------X-------B---B-------f-
-----------------------X----------------------------XX----------B------------------------------B---------------------X---B-------XB------------------X---------X--------------------------------------f-
-m----------B------------------------------------M---------M-------------------------X------------o---------o------------X------------X--------------------------------------X---------------------?--X-
XXXXXXXXXXXXXXXXX-XXXXXX-XXXXXXXX-XXXXXXXXXXXXXXXXXXXXXXXXXXXXXXXXXXXX-XXX-XXXXXXXXXXXXXXXXXXXXXXXXXXXXXXXXXXXXXXX-X-XXXXXXXXXXXXXXXXXXXXXXXXXXX-XXXXXXXXXXXXXXXXXXXXXXXXXX-XX-XXXXXXXXXXXXXXXXXXXXXXXXX
