---X--X-------------------------X-----BB---------X----B-------X----B--------------X--X-------o--------------------------X--------------------------------------X-----------------------X----------------
----------------------------------------------------X---------------------XX----------------X----X-X---------------------------------------------------------------X------X--------------------X--------
------------------------------------------------B--------------------------------------------B---------------------------------X----------------------------B----------------------------------XX-------
-----------B-----------------------------X--------------------------------------------X------B-----------X--------------B--X--XX------------X----------------------------------------------X------------
--------B---B-------X-------------------------------------------------------X---X------------------------X------------------------------------------------X-------------------B---------------------X---
----------------X------X----B--------------------------------X---X--X------------------B---------o------------B-X---X---B--------------------------B------------------B---------------------------------
----------------X--X----------------------B-----------X----------X------B---X---------------------X-----------B--------X---B----------BX-----------------------------------------------------------X----
-------------------------?B-----------X----X-------X---X--------------------X----------X--------------------X-----X--------------B----------X----------B----------------------------------------X------v
-----X-B---X--------------X---B------------------B-------------------------------B----------------------------------------BB---------------X--------------X---------------------------------B----------f
-------------------------------X------X-X---X-----------B----X-------------------X-------------X-------------------------------------------X------------------------------X-----------BB--------X------f
-----------------------X-------------------------B----------------------------------------------X-----------------B-B--------------X---------------------------------B----------------------------X----f
----------------------------------------X---------BB----------B------------X---------------------X----------XX---------------B-X-----------------------------------X-B-------B--X-X-------XB-----------f
------X-----X---X---------B-------------------X-B---------------------------------------------------B-----------X------------B-------BX------------X---------------B--------B-------------B-B----------f
----X-------X--------B-------X----B-------BX---------------------------------------X-X-B-----X-----------X-X-----------------------------------------------X----------BX-------------------------------f
m-----B---------------B--------------?-------------X------B-----------------o---------------B--------------o-------B---o----o-----------------------------------------------o-------X-------B----M-----X
XXXXXXXXXXXXXXXX--XXXXXX-XXXXXXXXX-XXXXXX-XXXXX-XXXXXXXXXXXXXXXXXXXXXXX-X-XXX-XXXXXXXXXXXXXXXXXX-XXXXXXXXX-XXXXX-XXXXXXXXXXXXXXXXXX-XXX-XXX-XXXXXXXX-XXXXXX-XXXXXXXXXXXXXXXXXXXXXXXXXXXX-XXXXXXXXXXXXXXX
