-----------X-----------X---X---------------------------B---X-----------------B--B---------------------------X---X------B------------------X-----------------X-----------------------------------B-------
-B-----------------B-------------B--------B----X----------X-----B----------X---------------X-------------------------X-----------------X--B--X---B---------------------------------B--------------------
-------------------------X---------------------------X-----X-----X----------------B----------------------------------------X----X--X--X------------------B-----------------------X----X-------B---------
----------------------------------------B-----------------B--------------------------------B---------X----X----------B---------------------------------X---------B-B------------------------------------
-----X---------X-----------------B--------------------------------B--------------------------------------------BX--X----B--X----------X-----------X-----------------X-----------------------------------
-----------X------------------B--------------------------X---X-------X-----------------X--------------X------X------------------X-------B-------------------------------------------X-----B-----------B-
--B--B----------X--X---------X----------B------------X----------B----------------------------------------------------------------------X--------------------------------------------------B---X---X-B---
--------------------------------------X------------------------------------------------------------------------------BB------------------M--B--------XX---X-----X-----X---------------------X--B------v-
-------------------------------X-----------------------------------------X------X--X------X---------------------------------X--B----------X--------------X----------------X---------------------------f-
---------------------------------------X-X--------------------------X---------------------------B---------XX-------------------B--------------------------B---------------------------------XB-X-X----f-
-B-------------------------------------B-------------------------------------X------X-----X--------------XX---------B-B------------B-X----------------------------------------------------------------X-
--------------------------------------X---XX----------------X--------B-----------X-----B-------B------------------------?------B------------------B-X-------------------------------------------------f-
---B----B---X--------------------------------------B------------oX-----------------------------B-----------------------B----------------------X----------X----X------------------------X--------------f-
----?--------B------B------------B--------B-------X---B----------X--------------B--X--B------------------------X-------------------------B----------------X-------------------------------------------f-
-m---X------------o---------X|----------------|-------------------B----------------?--------B------------X----M------B--------X----M---------------o------o--o--?------------------------BB-----------X-
X-XXXXXXXXXXXXXXXXXXXXX-XX-X-XXX-XXXXXXXXXXXXXXX-XXXX-X--XX-XXXXXXXXXXXXXXXXXXXXXXXX-XXXXXXXXX-XXXXX-XXXXXXXXXXXXXXXXXXXXX-XXXXXXXXXXXXXXXXXXXXXXXX-XXXXXXXXX-XXXXX-XXXXXXXXXXXXXXXXXXXXXXXXXXXXXXXXXXXX
