----------X-----------------------------------------------------X-------------------------------X--------------B-------------------X----------X-X-----B----------------X---------B----------------------
-------------------X-------------------------------------------X---X----------------------------BB--------XB-----X---------B----------------------------------------------------X---------------X---B-X-
---------X--------------X---X------X--------------------------------BX------------------------------------------------X-------------------X-----------B-----------X--------X----------XB----------------
-X-----X-------------------------------X--B--------------------X---X----------X--B----------X-X----X---XB-----------------------X--------------X-----------------------B--B--------------------X--------
-------------------B---------B------------------X---------X-------------------------------------------------------------------------X----B-------XX-X----------------X-X---X-X------------X-------B-----
----------X-------B--------------?--------------------X---------------------X----------X-------X--------------------------------B----B-X------------X--------X-------------------------------------XX---
---------B-------------B---------X--------------------------X-------B----------------------------------------------X-----------X--------------XX-----X----BB--------------------------------------------
-----------------XX------B----X-------X------------------B---------------B----------------------------X-------X--------B----X-------------------------------------------X---------------B-----X---X----v
--B----X------------X----------------X--------------------XX----------B------------------------------------------X---X----------------X-----------------------X--XX---------X--------------X-----------f
--------------------B----------------------------------------------B--------------------------------------B----X--X--B--X---------------------X----------------X-----B---X---------X-------------------f
---X--X----------------------------B----------------------------X---------X-----------------------------B---X--------------B----------B--------------B-----------------------X------X-B--------X---B---f
---------B--X---X---------X--------B-----------------X-X----M--------X-X--X------------------------------------------------------------Xo--------------------------------------------------------X-----f
-------------X--------------------X--------------------X----X-B-------------B--------------------------X----X--B--------BX-------------X---------XB--------B-------------------------------------------f
------------X--------------------X-------------X-----X----------X------X------------X----------B----------------------X----------X---------------------------------X----------X----------B--------X----f
m------------------------------------o---------------------------------------o---------------------------------M----------X----------------------------------------------------------------X-----X-----X
XXXXX--XXXXX-XXXXXXXXXX-XXXXXXXXXX-XXXXXXX-XXXXXXXX--X-XXXX-XXXX-X-X-XX-XXX-XXXXXXX-XXXXXXXXXXXXXXXXXX-XXXXXXXXXXXXXXXXXXXX-XXXXXXXXXXXXXXX-XXXXXXXXXXXXXXXXXXXX-XXXXXXXXXXXXXXXXXXXXXX-XXXXXXXX-XXXXXXX
