-----------X-----------------X----------------------------------------------------------------------------BX-B--------X---------------------------------------------------------------------------------
----------------X----------------------------X-------------X--------------X--X-------------------------------------------------------------------------------------------------X---------X---------X----
---B-------X------------B----B--------------BX-----B-------------------------------X------------X--------------------B-----------------B---------------------------------------------------------X------
-------------------B--X---------------------------------------------X-------X------X-------X-----X---------------------X-------------X----------XX---------X------------------X--------B-----X----------
---------X--X---------------------------------------------------X---------------X------X------X----------------------------------------M---------------------X----------------------------X----B--------
-------------X-X-----B-----B-------------------X------------------X---X-----X--X--B-------B---------------------------------X-----------X--XB--X-----B------------------------X-------------------X--B--
------------------------------X---X-X-X---------------X------------------------B----------------------X-----------------------------------------B--X-X----------B----------------------------------X----
--------o------------B-----M---------------------------------X-------------------------B-X-----------X-----------X-----------X----X---------------X-X-X--------X------------B---X------X---------------v
--B----X----------------X--B------B---------------------------------------------------X---------------------?X----------------X----------------------------------------------------------------------X-f
--------X-------------------B-------------X--------------X-------X-----------------------------------XX------X------------------------------------------X----------XX---------------------B---X-----B--f
--------------------------XX--------X-----B------X---------------------------B------------------------------------B---------------X-------------X--X----X---X----------X---X-----------X---------------f
---------X--------------------B--------------X----------------------------------------------------------------------------X----------X-------B-----------------------------X--------------B------------f
-X-X---X---------------------B-----------X-----X---------------------------------X----------------------------X-------X------X---------------------X----X----------------------------------------------f
-----------------------------------------------------------B--------X--XX-X------B--X-----X-B-----X--------------------------------B-------------------------?--------BBX------B----------------B------f
m-----------------------?--------------o---------------X--------M----------o--------o--M-----------?------------B-------------------M----XX---------------B---|-X---B---------B------------------------X
XXXXXXXXXXX--XX-XXXXXXXXXXXXX-XXXXXXXXXX-XXXXXXX-XXX-XXX-XXXXXXXXXXXXXX-XXXXXXXXXXXXX-XXXX-XXXXXXXX-XXXXXXXX--XXXXXXXXXXXXXX-XXXXXXXXXXXXXXXXXXXXXXXXXX-X-XXXX-XXXXX-XX-XXXXXXXXXXXXXXXXX-XXX-XXXXXXXXXX
