-------------------------------------------------X-----X--------------------------------B-------------------------X--X----B-------------X-----B-------------------B-------------------------------------
----------------------------------------X------------------------------------------------------------------------X-----X-------X---------X-------------------------------X-----------------------B------
---------------X---------------------------------------X------------------B--------------X----XX-------------------------------------------X------------------B-----B-----------------------------------
----------------------B-B------X---------------X-XB---------------------------------------------X---------------X------------------------X-------------------------------B-------------B----B-----------
-------------------B------------------------------------X--------X---------X------BX---------B----------------X--------------X----------------------B---------------------------------------------------
-----BX---------------------------------------------------------B------------------------------------------------------------------------------------------X--------------B--X--------X-----------------
----B-----X-------------------------B-----XX--------------------------X-----------------------B------------------------------B---------------X----X-----------------------------------------------------
----------------o-------------------B------------------------------------X----------------------X-------X-----------X---------------------X---------------------------------------------o-------B-------
------------X----X--B-----------------------------------------X-o-------X-----------------------B----------------------------------Bo-----------------B-----X-X--------------------------B--------X---f-
---------M--------------X--------------------------------X-B-----B---------X-----------X---------------------------------X-----o---B-----------------------X---------B--------------------------------f-
----------B---X-------X-----------------------------------B----------------------X------X-------------------X------------------B-----------X----------X-----------------------------------------------f-
--------------X---------B-----X-----------------------------X---------X----------------------------------B--------------------------------------------X---X--------------X-------------X-------X------f-
-------------------------------XX-------X--------------------------X-----------------------X-------------------------------------------------------------X----------------------------------------------
-----------------------------------X-----------------------------------------------------X--------------B----------------B---------X--------------------------------------------X-----------B---------f-
-B---X------o---------------XB-------------------------------------------B---------M-----X--B----?--X-------------------------|---------------------X-------------X-------o---?-----oX------?---o-----X-
XXXXXXXXX-XXXXXXXXXXXXXXXXXXXXXXXXXXXXXXXXXXX-XXXXX-XXXXXXXXXXXXXXXXXXXXXXXXXXXXXXXXXXXXXXXXXXXXXXXXXXXXXXXXX-XXXXXXXXXXXXXXXXXXXXXXXXXXXX-XXXXXXXXXXXXXXXXXXX-XXXXXXXXXXXXXXXXXXX-XXXXXXXXXXXXXXXXXXXXX
