------------------------------------------------------X----------------X-------B-------X-------------X------------X--------X-------------------------------X--------------------------------------------
------------------------------------------X--B------------------------------------B----------BX------B--------X-------------------------------------------B---------------------------------------------
-B-----------------------------------X-------------------------B-------------------------------X----------------------X---------------------o-----------X----------X---------------------------BX-------
------------X---B-------------------------X-----X-------?---X---------------X--------------------------------------------------------------B------------------------------X--------X--------------------
------------B--------------------------------------B-----B-------------X-----------XB----------X-----------------B------------------B--------X----------X-------------------------BX--------------------
-----------X----------------X------B----B--------------------------------------------------X----X---B----------X--------------X------------XX-------X----B--------------X----------------B-----------XB-
-------------------------------------------------X-----------------------------------------B---------------------------------------------X-X--------------------------------------------------------X---
-------------X-B---------------------------B--------------------B-----------------X----------------B---------------------------------X----------------X-----------------B----X------------------------v-
----------------------------------------X-----B---------------------------------------------------------------B----------------------B------X-------X-----XX--------------------------------X---------f-
-------------------------------------XX-X------------------X------------------------------X--------------X--------------------------------------------------------------------------------------------f-
----------X---------------X---------------------------------------------------------X----------------------------------------B---------------------X--------------------------------------X-----------f-
---X---B---------------------------X--------X-------------------X-------------------------------------------------------------------------------------X--X--------------B-B------X--------------------f-
--------------------B-----------------------------------------B---B----X----------------------X----------------------------------------X-------------------------X------------------------------------f-
------------------------X----X------------------------X---------------------------------X----X--------------------------X-----------B-----X--------------------------------------X--------------------?-
-m-----------X------------------------------------?-------------------------?--------------?-B-----o----------------------------|--------------------------------o----|X---?--------------------M-----X-
XXXX-XX-XXXXXXXXXXXXX-XXXXX-XXXXX-XXXXXXXXXXXXXXXXXXXXXXXX-XXXXXXXXXXXXXXXXXXXXXXXXXXXXXXXXXXXXXXXXXX-XXXXXXXXXXX-XXXXXXXXXXXXXXXX-XXXXXXXXXXXXXXXXXX-XXXXXXXXXXXXXXXXXX-XXXXXXXXXXXX-XXXXXXXXXXXXXXXXXX
